#character
1 1 1
#background
1 1 1 1 1 1 1 1 1 1 1 -1
1 1 1 1 1 1 1 1 1 1 1 -1
1 1 1 1 1 1 1 1 1 1 1 -1
1 1 1 1 1 1 1 1 1 1 1 -1
1 1 1 1 1 1 1 1 1 1 1 -1
1 1 1 1 1 1 1 1 1 1 1 -1
1 1 1 1 1 1 1 1 1 1 1 -1
1 1 1 1 1 1 1 1 1 1 1 -1
1 1 1 1 1 1 1 1 1 1 1 -1
1 1 1 1 1 1 1 1 1 1 1 -1
1 1 1 1 1 1 1 1 1 1 1 -2
#midground
0 10 10 10 10 10 10 10 10 10 10 -1
0 10 10 10 10 10 10 10 10 10 10 -1
0 10 10 10 10 10 10 10 10 10 10 -1
0 10 10 10 10 10 10 10 10 10 10 -1
0 10 10 10 10 10 10 10 10 10 10 -1
0 10 10 10 10 10 10 10 10 10 10 -1
0 10 10 10 10 10 10 10 10 10 10 -1
0 10 10 10 10 10 10 10 10 10 10 -1
0 10 10 10 10 10 10 10 10 10 10 -1
0 10 10 10 10 10 10 10 10 10 10 -1
0 10 10 10 10 10 10 10 10 10 10 -2
#end