#character
1 1 1
#background
1 1 1 1 1 1 1 1 1 1 1 -1
1 1 1 1 1 1 1 1 1 1 1 -1
1 1 1 1 1 1 1 1 1 1 1 -1
1 1 1 1 1 1 1 1 1 1 1 -1
1 1 1 1 1 1 1 1 1 1 1 -1
1 1 1 1 1 1 1 1 1 1 1 -1
1 1 1 1 1 1 1 1 1 1 1 -1
1 1 1 1 1 1 1 1 1 1 1 -1
1 1 1 1 1 1 1 1 1 1 1 -1
1 1 1 1 1 1 1 1 1 1 1 -1
1 1 1 1 1 1 1 1 1 1 1 -2
#midground
0 0 0 0 0 0 0 0 0 0 0 -1
0 10 10 10 10 2 10 10 10 10 6 -1
0 10 10 10 10 2 10 10 10 10 10 -1
0 10 0 0 0 0 0 0 0 0 10 -1
0 10 0 10 10 10 10 10 10 0 10 -1
0 10 0 10 10 10 10 10 10 0 10 -1
0 10 0 10 6 10 10 10 10 0 10 -1
0 10 0 10 2 10 10 10 10 0 10 -1
0 10 0 0 4 0 0 0 0 0 10 -1
0 10 10 10 10 0 8 4 10 10 10 -1
0 0 0 0 0 0 0 0 0 0 0 -2
#end