#character
1 1 1
#background
1 1 1 1 1 1 1 1 1 1 1 -1
1 1 1 1 1 1 1 1 1 1 1 -1
1 1 1 1 1 1 1 1 1 1 1 -1
1 1 1 1 1 1 1 1 1 1 1 -1
1 1 1 1 1 1 1 1 1 1 1 -1
1 1 1 1 1 1 1 1 1 1 1 -1
1 1 1 1 1 1 1 1 1 1 1 -1
1 1 1 1 1 1 1 1 1 1 1 -1
1 1 1 1 1 1 1 1 1 1 1 -1
1 1 1 1 1 1 1 1 1 1 1 -1
1 1 1 1 1 1 1 1 1 1 1 -2
#midground
10 10 10 10 10 10 10 10 10 10 10 -1
10 10 10 10 10 10 10 10 10 10 10 -1
10 10 10 10 10 10 10 10 10 10 10 -1
10 10 10 10 10 10 10 10 10 10 10 -1
10 10 10 10 10 10 10 10 10 10 10 -1
10 10 10 10 10 2 10 10 10 10 10 -1
10 10 10 10 10 10 10 10 10 10 10 -1
10 10 10 10 10 10 10 10 10 10 10 -1
10 10 10 10 10 10 10 10 10 10 10 -1
10 10 10 10 10 10 10 10 10 10 10 -1
10 10 10 10 10 10 10 10 10 10 10 -2
#end