#background
1 1 1 1 1 1 1 1 1 1 1 1 -1
1 1 1 1 1 1 1 1 1 1 1 1 -1
1 1 1 1 1 1 1 1 1 1 1 1 -1
1 1 1 1 1 1 1 1 1 1 1 1 -1
1 1 1 1 1 1 1 1 1 1 1 1 -1
1 1 1 1 1 1 1 1 1 1 1 1 -1
1 1 1 1 1 1 1 1 1 1 1 1 -1
1 1 1 1 1 1 1 1 1 1 1 1 -1
1 1 1 1 1 1 1 1 1 1 1 1 -1
1 1 1 1 1 1 1 1 1 1 1 1 -1
1 1 1 1 1 1 1 1 1 1 1 1 -1
1 1 1 1 1 1 1 1 1 1 1 1 -2
#midground
10 10 10 10 10 10 10 10 10 10 10 10 -1
10 10 10 10 10 10 10 10 10 10 10 10 -1
10 10 10 10 10 10 10 10 10 10 10 10 -1
10 10 10 10 10 10 10 10 10 10 10 10 -1
10 10 10 10 10 10 10 10 10 10 10 10 -1
10 10 10 10 10 10 10 10 10 10 10 10 -1
10 10 10 10 10 10 10 10 10 10 10 10 -1
10 10 10 10 10 10 10 10 10 10 10 10 -1
10 10 10 10 10 10 10 10 10 10 10 10 -1
10 10 10 10 10 10 10 10 10 10 10 10 -1
10 10 10 10 10 10 10 10 10 10 10 10 -1
0 1 2 4 5 6 7 8 9 11 13 1 -2
#end