#character
2 1 1
#pressurePlate
1 1 2 5 0
#pressurePlate
9 3 9 4 0
#pressurePlate
9 5 6 3 0
#background
1 1 1 1 1 1 1 1 1 1 1 -1
1 1 1 1 1 1 1 1 1 1 1 -1
1 1 1 1 1 1 1 1 1 1 1 -1
10 1 1 1 1 1 1 1 1 1 1 -1
10 1 1 1 1 1 1 1 1 1 1 -1
10 1 1 1 1 1 1 1 1 1 1 -1
10 1 1 1 1 1 1 1 1 1 1 -1
10 1 1 1 10 10 10 10 1 1 1 -1
10 1 1 1 -2
#midground
0 0 0 0 0 0 0 0 0 0 0 -1
0 11 10 10 10 10 0 10 10 10 0 -1
0 0 10 0 2 2 10 10 10 2 0 -1
10 0 4 2 6 0 15 0 0 11 0 -1
10 0 10 0 10 10 10 0 0 15 0 -1
10 0 15 0 10 10 10 10 2 11 0 -1
10 0 10 0 0 0 0 0 0 10 0 -1
10 0 8 0 10 10 10 10 0 0 0 -1
10 0 0 0 -2
#end