#character
1 1 1
#teleporter
3 0 9 0 1
#background
1 1 1 1 1 1 1 1 1 1 1 -1
1 1 1 1 1 1 1 1 1 1 1 -1
1 1 1 1 1 1 1 1 1 1 1 -1
1 1 1 1 1 1 1 1 1 1 1 -1
1 1 1 1 1 1 1 1 1 1 1 -1
1 1 1 1 1 1 1 1 1 1 1 -1
1 1 1 1 1 1 1 1 1 1 1 -1
1 1 1 1 1 1 1 1 1 1 1 -1
1 1 1 1 1 1 1 1 1 1 1 -1
1 1 1 1 1 1 1 1 1 1 1 -1
1 1 1 1 1 1 1 1 1 1 1 -2
#midground
10 10 10 7 0 0 0 0 0 7 10 -1
10 10 10 0 0 0 0 0 0 0 10 -1
10 10 10 10 10 2 10 2 10 10 10 -1
10 10 10 10 2 6 2 6 2 10 10 -1
10 10 10 10 10 2 2 2 10 10 10 -1
10 10 10 10 10 2 2 2 10 10 10 -1
10 10 10 10 2 2 2 2 2 10 10 -1
10 10 0 0 2 2 2 2 2 0 0 -1
10 10 0 0 2 2 2 2 2 0 0 -1
10 10 10 10 2 2 2 2 2 10 10 -1
10 10 10 10 4 10 10 10 4 10 8 -2
#end