0 0 0 0 0 0 0 0 0 0 0 0 0 0 0 -1

0 2 2 2 22 2 2 4 5 2 2 2 4 5 2 2 2 4 5 2 2 2 4 5 2 2 2 4 5 2 2 2 4 5 2 2 2 4 5 2 2 2 4 5 2 2 2 4 5 2 2 2 4 5 2 2 2 4 5 2 2 2 4 5 2 2 2 4 5 2 2 2 4 5  2 4 5 2 2 2 4 5 2 2 2 4 5 2 2 2 4 5 2 2 2 4 5 2 2 2 4 5 2 2 2 4 5 2 2 2 4 5 2 2 2 4 5 2 2 2 4 5 2 2 2 4 5 2 2 2 4 5 2 2 2 4 5 2 2 2 4 5 6 8 1 -1

0 3 5 6 7 8 0 2 2 2 4 5 2 2 2 4 5 2 2 2 4 5 2 2 2 4 5 2 2 2 4 5 2 2 2 4 5 2 2 2 4 5 2 2 2 4 5 2 2 2 4 5 0 0 0 5 3 8 0 0 0 0 0 -1

0 1 1 0 2 2 2 4 5 2 2 2 4 5 2 2 2 4 5 2 2 2 4 5 2 2 2 4 5 2 2 2 4 5 2 2 2 4 5 2 2 2 4 5 2 2 2 4 5 2 2 2 4 5 2 2 2 4 5 2 2 2 4 5 2 2 2 4 5 2 2 2 4 5 2 2 2 4 5 2 2 2 4 5 2 2 2 4 5 2 2 2 4 5 2 2 2 4 5 2 2 2 4 5 2 2 2 4 5 2 2 2 4 5 2 2 2 4 5 0 5 5 4 -1
0 2 2 3 8 4 5 0 0 1 0 5 6 7 -1

0 0 0 0 0 0 0 0 0 0 0 0 0 0 0 0 0 0 0 0 0 -1

0 2 3 4 8 6 4 -1

0 2 2 2 4 5 2 2 2 4 5 2 2 2 4 5 2 2 2 4 5 2 2 2 4 5 2 2 2 4 5 2 2 2 4 5 2 2 2 4 5 2 2 2 4 5 2 2 2 4 5 2 2 2 4 5 2 2 2 4 5 2 2 2 4 5 2 2 2 4 5 2 2 2 4 5 2 2 2 4 5 2 2 2 4 5 2 2 2 4 5 2 2 2 4 5 2 2 2 4 5 2 2 2 4 5 2 2 2 4 5 2 2 2 4 5 2 2 2 4 5 2 2 2 4 5 2 2 2 4 5 2 2 2 4 5 2 2 2 4 5 2 2 2 4 5 2 2 2 4 5 -1

0 2 3 4 8 6 4 -1

0 2 3 4 8 6 4 -1

0 5 6 2 2 2 4 5 2 2 2 4 5 2 2 2 4 5 2 2 2 4 5 2 2 2 4 5 2 2 2 4 5 2 2 2 4 5 2 2 2 4 5 2 2 2 4 5 2 2 2 4 5 2 2 2 4 5 2 2 2 4 5 2 2 2 4 5 2 2 2 4 5 2 2 2 4 5 2 2 2 4 5 2 2 2 4 5 2 2 2 4 5 2 2 2 4 5 2 2 2 4 5 2 2 2 4 5 2 2 2 4 5 2 2 2 4 5 2 2 2 4 5 2 2 2 4 5 2 2 2 4 5 2 2 2 4 5 2 2 2 4 5 2 2 2 4 5 2 2 2 4 5 7 8 4 2 4 5 0 0 5 3 5 4 8 -1

0 0 0 2 2 2 4 5 2 2 2 4 5 2 2 2 4 5 2 2 2 4 5 2 2 2 4 5 2 2 2 4 5 2 2 2 4 5 2 2 4 5 2 2 2 4 5 2 2 2 4 5 2 2 2 4 5 2 2 2 4 5 2 2 2 2 2 2 4 5 2 2 2 4 5 2 2 2 4 5 2 2 2 4 5 2 2 2 4 5 8 0 -1

0 0 0 0 0 0 0 0 0 0 0 0 0 0 0 -2
