#character
1 1 1
#teleporter
4 0 4 5 0
#background
1 1 1 1 1 1 1 1 1 1 1 -1
1 1 1 1 1 1 1 1 1 1 1 -1
1 1 1 1 1 1 1 1 1 1 1 -1
1 1 1 1 1 1 1 1 1 1 1 -1
1 1 1 1 1 1 1 1 1 1 1 -1
1 1 1 1 1 1 1 1 1 1 1 -1
1 1 1 1 1 1 1 1 1 1 1 -1
1 1 1 1 1 1 1 1 1 1 1 -1
1 1 1 1 1 1 1 1 1 1 1 -1
1 1 1 1 1 1 1 1 1 1 1 -1
1 1 1 1 1 1 1 1 1 1 1 -2
#midground
10 10 10 10 9 10 2 10 10 10 10 -1
10 10 10 10 0 2 2 2 10 10 10 -1
10 10 10 10 2 2 2 2 2 10 10 -1
10 10 10 2 2 2 2 2 2 2 10 -1
10 10 10 0 0 0 0 0 0 0 10 -1
10 10 10 0 9 2 10 10 10 0 10 -1
10 10 10 0 2 2 2 2 10 0 10 -1
10 10 10 0 10 2 6 10 10 0 10 -1
10 10 10 0 10 2 10 2 10 0 10 -1
10 10 10 0 10 10 10 10 10 4 8 -1
10 10 10 0 0 0 0 0 0 0 10 -2
#end