#character
1 1
#pressurePlate
10 1 9 10 0
#pressurePlate
1 10 8 10 0
#background
1 1 1 1 1 1 1 1 1 1 1 1 -1
1 1 1 1 1 1 1 1 1 1 1 1 -1
1 1 1 1 1 1 1 1 1 1 1 1 -1
1 1 1 1 1 1 1 1 1 1 1 1 -1
1 1 1 1 1 1 1 1 1 1 1 1 -1
1 1 1 1 1 1 1 1 1 1 1 1 -1
1 1 1 1 1 1 1 1 1 1 1 1 -1
1 1 1 1 1 1 1 1 1 1 1 1 -1
1 1 1 1 1 1 1 1 1 1 1 1 -1
1 1 1 1 1 1 1 1 1 1 1 1 -1
1 1 1 1 1 1 1 1 1 1 1 1 -1
1 1 1 1 1 1 1 1 1 1 1 1 -2
#midground
0 0 0 0 0 0 0 0 0 0 0 0 -1
0 10 10 10 10 10 2 10 10 10 11 0 -1
0 10 10 10 10 10 2 10 10 10 10 0 -1
0 10 10 10 10 10 2 10 10 10 10 0 -1
0 10 10 10 10 10 2 10 10 10 10 0 -1
0 10 10 10 10 10 2 10 10 10 10 0 -1
0 10 10 10 10 10 2 10 10 10 10 0 -1
0 10 10 10 10 10 2 10 10 10 10 0 -1
0 10 10 10 10 10 2 10 10 10 10 0 -1
0 10 10 10 10 10 2 10 10 0 0 0 -1
0 11 10 10 10 10 2 10 4 4 8 0 -1
0 0 0 0 0 0 0 0 0 0 0 0 -2
#end