#character
1 1
#background
1 1 1 1 1 1 1 1 1 1 1 1 -1
1 1 1 1 1 1 1 1 1 1 1 1 -1
1 1 1 1 1 1 1 1 1 1 1 1 -1
1 1 1 1 1 1 1 1 1 1 1 1 -1
1 1 1 1 1 1 1 1 1 1 1 1 -1
1 1 1 1 1 1 1 1 1 1 1 1 -1
1 1 1 1 1 1 1 1 1 1 1 1 -1
1 1 1 1 1 1 1 1 1 1 1 1 -1
1 1 1 1 1 1 1 1 1 1 1 1 -1
1 1 1 1 1 1 1 1 1 1 1 1 -1
1 1 1 1 1 1 1 1 1 1 1 1 -1
1 1 1 1 1 1 1 1 1 1 1 1 -2
#midground
0 0 0 0 0 0 0 0 0 0 0 0 -1
0 1 1 1 1 1 2 1 1 1 6 0 -1
0 1 1 1 1 1 2 1 1 1 1 0 -1
0 1 1 1 1 1 2 1 1 1 1 0 -1
0 1 1 1 1 1 2 1 1 1 1 0 -1
0 1 1 1 1 1 2 1 1 1 1 0 -1
0 1 1 1 1 1 2 1 1 1 1 0 -1
0 1 1 1 1 1 2 1 1 1 1 0 -1
0 1 1 1 1 1 2 1 1 1 1 0 -1
0 1 1 1 1 1 2 1 1 0 0 0 -1
0 1 1 1 1 1 2 1 1 4 8 0 -1
0 0 0 0 0 0 0 0 0 0 0 0 -2
#end