#character
1 1 1
#teleporter
10 1 9 10 0
#background
1 1 1 1 1 1 1 1 1 1 1 1 -1
1 1 1 1 1 1 1 1 1 1 1 1 -1
1 1 1 1 1 1 1 1 1 1 1 1 -1
1 1 1 1 1 1 1 1 1 1 1 1 -1
1 1 1 1 1 1 1 1 1 1 1 1 -1
1 1 1 1 1 1 1 1 1 1 1 1 -1
1 1 1 1 1 1 1 1 1 1 1 1 -1
1 1 1 1 1 1 1 1 1 1 1 1 -1
1 1 1 1 1 1 1 1 1 1 1 1 -1
1 1 1 1 1 1 1 1 1 1 1 1 -1
1 1 1 1 1 1 1 1 1 1 1 1 -1
1 1 1 1 1 1 1 1 1 1 1 1 -2
#midground
0 0 0 0 0 0 0 0 0 0 0 0 -1
0 10 10 10 10 10 2 10 10 10 7 0 -1
0 10 10 10 10 10 2 10 10 10 10 0 -1
0 10 10 10 10 10 2 10 10 10 10 0 -1
0 10 10 10 10 10 2 10 10 10 10 0 -1
0 10 10 10 10 10 2 10 10 10 10 0 -1
0 10 10 10 10 10 2 10 10 10 10 0 -1
0 10 10 10 10 10 2 10 10 10 10 0 -1
0 10 10 10 10 10 2 10 10 10 10 0 -1
0 10 10 10 10 10 2 10 10 0 0 0 -1
0 10 10 10 10 10 2 10 10 7 8 0 -1
0 0 0 0 0 0 0 0 0 0 0 0 -2
#end